日 : 日
事 : 一 口 亅 ヨ
人 : 人
一 : 一
見 : 見 目 儿
本 : 一 木
子 : 子
出 : ｜ 山
年 : ノ 一 干 乞
大 : 大
言 : 言
学 : 子 尚 冖
分 : 刀 ハ
中 : ｜ 口
記 : 言 已
会 : 二 个 厶
新 : 斤 辛 并 木 立 亠
月 : 月
時 : 寸 土 日
行 : 行 彳
気 : 气 丶 ノ 乞
報 : 十 辛 土 又 立 亠 卩
思 : 心 田
上 : 一 卜
語 : 言 口 五
自 : 自 目
者 : 日 老
生 : 生
文 : 文
明 : 月 日
情 : 月 青 土 二 忙 亠
国 : 王 囗 丶
朝 : 月 十 日
用 : 用
書 : 日 聿
私 : 禾 厶
手 : 手
間 : 日 門
小 : 小
合 : 口 个 一
方 : 方
社 : 土 礼
検 : 口 人 木 个
目 : 目
前 : 一 刈 月 并
入 : 入
索 : 糸 幺 小 十 冖
関 : 人 大 二 ハ 門 并 一
作 : ｜ ノ 化 一 乞
特 : 牛 寸 土
何 : 化 口 亅 一
女 : 女
今 : 个 一
体 : 木 一 化
動 : ｜ 一 日 力 里 ノ
集 : 木 隹
発 : 二 儿 癶
最 : 一 耳 日 又
内 : 人 冂
投 : 扎 殳 几 又
下 : ｜ 一 卜
知 : 口 矢 乞
地 : 土 也
場 : 土 日 勿 一 勿
別 : 刈 口 力 勹
話 : 言 口 舌
部 : 口 邦 立
化 : 化 匕
告 : ノ 口 土
法 : 汁 土 厶
広 : 厶 广
来 : ｜ 二 米 亠 木
田 : 田
理 : 王 里
物 : 勿 牛 勹 ノ
開 : 一 門 廾 二 ノ
全 : 王 ハ 个
説 : 言 口 并 儿
聞 : 耳 門
表 : 衣 士 土 二 亠
連 : 込 車
無 : ｜ ノ 一 杰 無 乞
対 : 寸 文
的 : 白 丶 勹
高 : 口 高 亠 冂
教 : 子 老 攵 乞
感 : ノ 口 心 戈
心 : 心
以 : ｜ 人 丶
成 : ノ 戈
名 : 口 夕
業 : ｜ 一 王 并 木 羊 耒
長 : 長
家 : 宀 豕
稿 : 禾 口 高 亠 冂
定 : 疋 宀
実 : 士 大 宀
山 : 山
近 : 斤 込
現 : 王 見
後 : 夂 幺 彳
金 : 金 王 ハ 个 并
覧 : ノ 見 臣 二 乞
男 : 田 力
画 : 一 田 凵
性 : 生 忙
度 : 又 广 一 凵
数 : 女 米 攵 夂 乞
立 : 立
彼 : 皮 又 彳
問 : 口 門
二 : 二
意 : 音 心 日 立
能 : 月 匕 厶
個 : 化 口 十 囗
僕 : 王 化 并 羊 大 二
通 : 込 用 マ
面 : 面
回 : 口 囗
代 : 化 弋
木 : 木
利 : 禾 刈
経 : 糸 幺 小 土 又
使 : ノ 一 化 口
車 : 車
編 : ｜ 一 戸 糸 幺 小 冂 冊 尸 廾
同 : 口 冂 一
平 : 干 并
音 : 音 日 立
読 : 言 士 儿 冖
少 : ノ 小
食 : 食
道 : 込 自 并 首
世 : ｜ 一 世
結 : 口 士 糸 幺 小
力 : 力
楽 : 白 木 冫
真 : 一 十 ハ 目
品 : 口 品
考 : 老 勹
公 : ハ 厶
野 : 矛 里 亅
込 : 込 入
所 : 斤 戸 一 尸
不 : ｜ ノ 一 丶
当 : ヨ 尚
取 : 耳 又
在 : ｜ ノ 一 土
電 : 雨 田 乙
愛 : 心 爪 冖 夂
外 : 卜 夕
載 : 車 土 戈
向 : 口 冂
美 : 王 大 并 羊
返 : 込 又 厂
仕 : 化 士
版 : 片 又 厂
際 : ノ 示 二 小 癶 阡
変 : 亠 夂
示 : 示 二 小
親 : 見 辛 并 木 立 亠
治 : 口 汁 厶
政 : 一 止 攵 乞
島 : 山 鳥 白
権 : 矢 木 隹 乞
解 : 角 牛 刀
他 : 化 也
先 : ノ 土 儿
掲 : 日 勹 匕 扎
川 : 川
三 : 一 二
口 : 囗 口
機 : ノ 木 丶 幺 戈
風 : 風 几 虫 ノ
東 : ｜ 一 日 木 田
市 : 巾 亠
付 : 化 寸
持 : 寸 土 扎
式 : 工 弋
加 : 口 力
界 : 田 个 儿
要 : 女 西
信 : 化 言
多 : 夕
更 : ノ 一 日 田
活 : ノ 口 十 汁 舌
選 : ｜ 込 二 ハ 已
題 : 貝 目 ハ 日 疋 頁
屋 : 至 土 厶 尸
論 : ｜ 一 言 个 冊 廾
郎 : 艮 邦
済 : ｜ ノ 汁 文 廾 斉
有 : ノ 一 月
身 : 身
線 : 糸 幺 小 水 白
味 : ｜ 口 二 ハ 木 亠
著 : 日 老 艾
顔 : 貝 目 ハ 頁 立 亠 厂 彡
売 : 士 儿 冖
空 : 穴 工 儿 宀
続 : 士 糸 幺 小 儿 冖
第 : 弓 竹 乞
様 : 王 水 并 木 羊
海 : 汁 母 毋 乞
始 : 口 女 厶
校 : 父 木 亠
英 : ノ 艾 大 冖
勝 : 月 人 大 二 并 力
母 : 母 毋
次 : 欠 冫
点 : 口 卜 杰
正 : 一 止
科 : 禾 斗
京 : 口 小 亠
術 : 行 十 丶 彳 木
転 : 車 二 厶
録 : ヨ 金 水 隶
初 : 初 刀
葉 : 木 世 艾
相 : 木 目
約 : 糸 幺 小 丶 勹
終 : 糸 幺 小 夂
育 : 月 亠 厶
住 : 王 化 丶
白 : 白
等 : 寸 竹 土 乞
声 : 士 尸
俺 : 乙 化 大 奄
字 : 子 宀
決 : 汁 人 大 二 ユ
登 : 口 豆 并 癶
北 : 匕 爿
案 : 女 木 宀
天 : 一 大 二
産 : ノ 生 并 立 亠 厂
切 : 刀 匕
都 : 日 邦 老
格 : 口 木 夂
主 : 王 丶
県 : 小 目
資 : 貝 目 ハ 欠 冫
井 : ｜ ノ 一 二 井
十 : 十
元 : 二 儿 元
戦 : 十 尚 田 戈
想 : 心 木 目
原 : 小 白 厂
指 : 日 匕 扎
円 : 冂 亠 一 ｜
店 : 口 卜 广
死 : 一 夕 匕 歹
容 : 穴 口 谷 ハ 个 宀
流 : 汁 川 亠 厶
過 : 口 込 冂
保 : 化 口 木
町 : 一 田 亅
足 : 口 足 止
介 : ハ 个
料 : 斗 米
安 : 女 宀
着 : ノ 王 并 目 羊
健 : 化 廴 聿
調 : 言 口 土 冂
芸 : 二 厶 艾
違 : 口 込 韋
研 : ｜ 口 石 亅 廾 ノ 二 一
古 : 口 十
参 : 一 厶 彡
番 : 田 釆 米
館 : 口 食 宀 ｜
受 : 爪 又 冖
歩 : ノ 止 小
値 : 化 十 目 ｜ 一
歴 : 止 麻 木 厂 广
笑 : 禾 竹 大 乞
引 : ｜ 弓
形 : 廾 彡 ノ 二 一
村 : 寸 木
然 : 犬 夕 杰
果 : ｜ 田 木
和 : 禾 口
究 : 穴 九 儿 宀
重 : ｜ ノ 一 日 里
西 : 西
議 : 一 王 言 并 羊 亅 戈 手
奈 : 示 二 小 大
直 : 十 目 ｜ 一
確 : 口 石 宀 隹
強 : 弓 虫 厶
注 : 王 汁 丶
組 : 一 糸 幺 小 目
良 : 艮
辞 : 口 十 辛 舌 立
好 : 子 女
試 : 言 工 弋
可 : 一 口 亅
水 : 水
必 : ノ 心
送 : 込 并 大 一 二
万 : ｜ ノ 一
止 : 止
帰 : ヨ 刈 巾 冖
典 : ｜ 一 日 ハ
再 : ｜ 一 冂 王
門 : 門
写 : 一 冖 勹
神 : ｜ 日 礼 田
供 : ｜ 一 化 二 ハ
紹 : 口 糸 幺 小 刀
運 : 込 車 冖
設 : 言 殳 几 又
宮 : 口 宀 ノ
色 : 色 巴 勹
推 : 扎 隹
期 : 甘 月 ハ
員 : 貝 目 ハ 口
映 : ノ 日 大 冖
球 : 王 水 丶
技 : 支 扎 又 十
落 : 口 汁 夂 艾
放 : 方 攵 乞
紀 : 糸 幺 小 已
岡 : 并 冂 一 山 岡
藤 : ｜ 一 月 水 艾 二 大
計 : 言 十
予 : マ 一 亅
達 : 王 込 土 并 羊
図 : 斗 囗
支 : 支 十 又
追 : ｜ 口 込
張 : 弓 長
去 : 土 厶
応 : 心 广
康 : ヨ 水 广 隶
夜 : 化 夕 亠
民 : 口 氏 尸
光 : 一 尚 儿
父 : 父
工 : 工
頭 : 貝 目 ハ 口 豆 并 頁
配 : 酉 已
進 : 込 隹
験 : 口 人 馬 个 杰
号 : 一 口 勹
段 : ｜ 殳 几 又 ノ 一
囲 : 囗 井
宇 : 干 亅 宀
由 : ｜ 日 田
企 : 止 个
米 : 米
細 : 糸 幺 小 田
商 : 口 并 立 亠 儿 冂
太 : 大 丶
置 : 十 買 目 一 ｜
待 : 寸 土 彳
早 : 十 日
右 : ノ 一 口
念 : ｜ 一 心 个
棋 : 甘 ハ 木
友 : ノ 一 又
断 : 斤 米 ｜ 一
佐 : ノ 一 化 工
半 : ｜ 二 并 十
害 : 口 土 亠 宀 二
帯 : ｜ 一 巾 冖
像 : 化 勹 豕 口 一
票 : 示 二 小 西
提 : 日 疋 扎
覚 : 見 尚 冖
件 : 化 牛
得 : 寸 日 彳 一
展 : ｜ 衣 一 二 尸
悪 : ｜ 一 口 心
室 : 至 土 厶 宀
福 : 一 口 田 礼
起 : 走 土 已
乗 : ｜ ノ 一 禾 ハ
制 : ノ 刈 牛 巾 二
交 : 父 亠
病 : 一 人 冂 疔
各 : 口 夂 攵
質 : 貝 目 ハ 斤
千 : ノ 十
構 : 木 冂 一 十
限 : 艮 阡
優 : 一 化 心 白 冖 夂 自
残 : 歹 戈 二
院 : 二 儿 宀 阡 元
週 : 口 込 土 冂
詩 : 言 寸 土
星 : 生 日
横 : ｜ 黄 田 二 日 ハ 木 廾
基 : 一 甘 土 ハ
規 : 見 土 人 二 大
完 : 二 儿 宀 元
伝 : 化 二 厶
募 : 大 日 力 艾
総 : 糸 幺 小 心 ハ 厶
宙 : ｜ 日 宀 田
氏 : 氏
職 : 音 耳 日 立 戈
詳 : 王 言 并 羊
旅 : ノ 方 乞
買 : 貝 目 ハ 買
位 : 化 立
史 : ノ 口
青 : 月 青 土 二 亠
将 : 寸 爪 爿
条 : 木 夂 攵
博 : 十 寸 田 丶
履 : 日 夂 尸 彳 乞
単 : 十 尚 田
順 : 貝 目 ハ 川 頁
存 : ｜ ノ 一 子
突 : 穴 大 儿 宀
崎 : 口 山 大 ｜ 一
毎 : 母 毋 乞
夫 : 人 二 大
歌 : 一 欠 口 亅
五 : 五
飛 : 飛
深 : 汁 木 儿 冖
誰 : 言 隹
座 : ｜ 土 人 广
談 : 火 言
務 : 矛 力 夂
婚 : 氏 女 日
演 : 汁 田 ハ 宀 一
頼 : ｜ 貝 目 口 ハ 頁 木
価 : 化 西
戸 : 戸 一 尸
消 : 月 汁 尚
評 : ｜ 一 言 二 并
例 : 化 刈 歹
義 : 一 王 并 羊 亅 戈 手
常 : 巾 口 尚 冖
板 : 又 木 厂
視 : 見 礼
左 : ノ 一 工
振 : 衣 辰 厂 扎
医 : 矢 匚 乞
統 : 糸 幺 小 亠 儿 厶
坂 : 土 又 厂
団 : 寸 囗
台 : 口 厶
静 : 月 青 土 亅 亠 勹 ヨ 二
申 : ｜ 日 田
素 : 糸 幺 小 土 亠 二
香 : 禾 香 日
域 : 口 土 戈
四 : 儿 囗
観 : 見 隹 矢 乞
購 : ｜ 一 貝 目 ハ 冂 十
陽 : 一 日 勿 阡 勿
首 : 自 首 并 目
局 : 口 尸
石 : 口 石
戻 : 戸 大 一 尸
認 : 言 心 刀 丶
識 : 音 言 日 立 戈
興 : 臼 口 ハ 冂 一
呼 : ノ 口 并 亅
類 : 貝 目 ハ 大 米 頁
速 : ｜ 一 口 込 ハ 木
状 : 犬 爿
製 : 衣 刈 牛 巾 亠
係 : ノ 化 糸 幺 小
馬 : 馬 杰
共 : ハ ｜ 一 二
護 : 言 又 艾 隹
並 : ｜ 一 二 并
降 : 夂 阡 十
君 : 一 口 ノ ヨ
路 : 口 足 夂 止
雨 : 雨
省 : ノ 小 目
求 : 一 水 丶
沢 : 汁 尸 丶
百 : 一 白
側 : 化 貝 目 ハ 刈
土 : 土
離 : 亠 凵 禹 隹
反 : 又 厂
曜 : ヨ 日 隹
種 : ｜ 禾 日 里 ノ
紙 : 氏 糸 幺 小
象 : 勹 豕 口 一
助 : 目 力
頃 : 貝 目 ハ 頁 匕
飲 : 欠 食
携 : ノ 扎 隹 乃
望 : 王 亡 月
散 : 月 攵 廾 二 乞
財 : ノ 一 貝 目 ハ 亅
判 : ｜ 刈 二 并 十
難 : 艾 隹 大 口 亠 二
秋 : 火 禾
曲 : ｜ 日
姿 : 欠 女 冫
舞 : ｜ ノ 一 舛 二 夕 無 乞
師 : ｜ 一 巾 口
疑 : 疋 矢 匕 マ 乞
境 : 音 土 日 立 儿
探 : 木 儿 冖 扎
満 : ｜ 一 汁 二 冂 山 艾
純 : 糸 幺 小 屯
谷 : 口 谷 ハ 个
了 : 一 亅
清 : 月 汁 青 土 二 亠
程 : 王 禾 口
花 : 化 匕 艾
答 : 口 竹 个 一 乞
碁 : ｜ 一 口 石 二 ハ
火 : 火
南 : 干 十 并 冂
背 : 月 匕 爿
駅 : 馬 尸 杰 丶
器 : 口 大
環 : 衣 王 口 買 一
補 : 十 初 用 丶
夢 : 買 夕 冖 艾
材 : ノ 一 木 亅
施 : ノ 方 一 也 乞
差 : ノ 王 工 并 羊
標 : 示 二 小 西 木
園 : 衣 口 土 囗
両 : ｜ 一 冂 山
命 : 口 个 卩 一
障 : 音 十 日 立 阡
微 : 山 彳 攵 乞
禁 : 示 二 小 木
黒 : 黒 里 杰
建 : 廴 聿
営 : 口 尚 冖 ノ
森 : 木
根 : 艮 木
協 : 十 力
冷 : 个 冫 卩 一
走 : 走 土
折 : 斤 扎
量 : 一 日 里
端 : 山 而 立
居 : 口 十 尸
任 : ノ 王 化 士
若 : ノ 一 口 艾
造 : ノ 口 込 土
負 : 貝 目 ハ 勹
項 : 貝 目 ハ 工 頁
松 : ハ 木 厶
橋 : ノ 口 木 冂
区 : 匚 丶 ノ
型 : 刈 土 廾 ノ 二 一
依 : 衣 化 亠
街 : 行 土 彳
故 : 口 十 攵 乞
管 : 口 竹 宀 ｜ 乞
抜 : 夂 亠 扎 又
司 : 一 口 亅
茨 : 欠 冫 艾
士 : 士
態 : 月 心 匕 厶
押 : ｜ 日 扎 田
印 : ｜ 卩
幸 : 十 辛 立 亠
改 : 已 攵 乞
独 : 虫 犯
系 : ノ 糸 幺 小
整 : ｜ 一 口 止 木 攵 乞
息 : 自 心 目
衛 : 口 行 彳 韋
宅 : ノ 一 乙 宀
習 : 羽 白 冫
移 : 禾 夕
犬 : 犬 大 丶
株 : 牛 木
阪 : 又 厂 阡
訳 : 言 尸 丶
殺 : 木 殳 ノ 丶 几 又
弘 : 弓 厶
隆 : 生 夂 阡
犯 : 乙 犯 卩
兄 : 口 儿
急 : ヨ 心 勹
寄 : 一 口 大 亅 宀
収 : ｜ 又
休 : 化 木
堂 : 口 尚 土 冖
割 : 刈 口 土 宀 亠 二
志 : 士 心
兵 : 一 斤 ハ
忘 : 心 亡 亠
赤 : 赤 土
打 : 亅 扎
影 : 口 小 日 亠 彡
州 : ｜ 川 丶
階 : 白 比 阡
樹 : 口 寸 土 豆 并 木
修 : ｜ 化 彡 攵 乞
六 : ハ 亠
客 : 口 夂 宀
察 : ノ 示 二 小 宀 癶
夏 : 一 自 夂 目
雑 : 木 隹 九
之 : 乙 丶 亠 廴
歳 : ノ 止 小 戈
処 : 几 夂 攵
緒 : 糸 幺 小 日 老
絡 : 口 糸 幺 小 夂
罪 : 買 非
照 : 口 刀 日 杰
浮 : 子 汁 爪
軽 : 車 土 又
窓 : 穴 心 儿 厶 宀
含 : 口 个 一
弱 : 弓 冫
換 : 大 儿 冂 勹 扎
準 : 十 汁 隹
異 : 一 田 ハ 井
賞 : 貝 目 ハ 口 尚 冖
嫌 : ｜ ヨ 女 ハ 并
希 : ノ 一 巾
苦 : 口 十 艾
酒 : 汁 酉
査 : 一 木 目
刊 : 刈 干
欲 : 欠 口 谷 ハ 个
池 : 汁 也
般 : 舟 殳 几 又
宗 : 示 二 小 宀
沖 : ｜ 汁 口
失 : ノ 人 二 大
未 : ｜ 二 ハ 木 亠
尾 : 毛 尸
渡 : 汁 又 广
役 : 彳 殳 几 又
景 : 口 小 日 亠
列 : 刈 歹
草 : 十 日 艾
破 : 口 石 皮 又
針 : 金 十
周 : 口 土 冂
接 : 女 立 扎
城 : ノ 土 戈
林 : 木
薦 : 广 杰 艾
八 : ハ
販 : 貝 目 ハ 又 厂
寝 : ヨ 又 冖 宀 爿
熱 : 土 九 丶 儿 杰
我 : 亅 戈 手
便 : ｜ ノ 一 化 日 田
奇 : 一 口 大 亅
証 : 一 言 止
導 : 込 自 寸 并
角 : 角 勹 月 ｜
具 : 一 ハ 目
願 : 貝 目 ハ 小 白 頁 厂
至 : 一 至 土 厶
遠 : 衣 口 込 土
片 : 片
老 : 老 匕
末 : ｜ 一 ハ 木 亠
責 : 貝 目 ハ 土 亠 二
瞬 : 牛 舛 爪 目 夕 冖
途 : 込 ハ 个 亅 木 一
挙 : 手 尚 ハ
族 : 方 矢 乞
専 : 十 寸 田
絵 : 糸 幺 小 二 个 厶
響 : 音 艮 日 邦 立 幺
波 : 汁 皮 又
吉 : 口 士
絶 : 糸 幺 小 色
茶 : 个 艾 木
暮 : 大 日 艾
盗 : 欠 皿 冫
授 : 爪 又 冖 扎
貴 : ｜ 一 貝 目 ハ 口
悩 : 尚 忙 凵
遊 : 込 子 方 乞
幻 : 幺
撃 : 車 手 殳 几 又
効 : 父 力 亠
普 : ｜ 一 二 日 并
杯 : ｜ ノ 一 木 礼
王 : 王
策 : ｜ 巾 竹 ハ 木 亅 冂 乞
簡 : 竹 日 門 乞
焼 : 火 十 儿
宝 : 王 宀 丶
遅 : 王 込 并 羊 尸
療 : 小 日 并 大 疔
鉄 : ノ 金 二 矢 大 乞
乳 : 乙 子 爪
与 : 勹 一 卜
算 : 竹 目 廾 乞
玉 : 王 丶
浜 : 斤 汁 ハ 一
逃 : 込 儿 冫
府 : 化 寸 广
創 : 刈 口 个 一
働 : ｜ 一 化 力 日 ノ
津 : 汁 聿
増 : 田 土 日 并
復 : 日 夂 彳 ノ 一 人 乞
余 : 一 二 ハ 个 亅 示 小
児 : ｜ 日 儿
援 : ノ 一 爪 又 扎
競 : 口 立 儿
抱 : 勹 已 扎
装 : 衣 士 爿 亠
雄 : ノ 一 厶 隹
恋 : 心 ハ 亠
央 : ノ 一 大 冖
越 : 走 土 戈
久 : ノ 入 久
賀 : 貝 目 ハ 口 力
九 : 九
暗 : 音 日 立
謝 : 言 身 寸
江 : 工 汁
里 : 里
眠 : 口 氏 目 尸
非 : 非
鮮 : 王 魚 田 并 羊 杰
似 : 化 人 丶
冬 : 夂 丶 攵
激 : 汁 白 方 攵 乞
極 : 口 又 木 一
替 : 人 大 二 日 亠
春 : 一 二 日 人 大
薬 : 日 木 冫 艾
痛 : 用 疔 マ
留 : 田 刀 厶
警 : 言 口 勹 夂 艾 攵 乞
血 : 血 皿
曰 : 曰
巨 : 匚 巨
払 : 厶 扎
比 : 比
席 : 巾 广 一 凵
備 : 化 用 厂 艾
防 : 方 阡
章 : 音 十 日 立
脳 : 月 尚 凵
費 : ｜ 貝 目 ハ 弓
刷 : 刈 巾 尸
誤 : 言 口 ハ
災 : 火 巛
複 : 初 日 夂 乞
触 : 角 虫
辺 : 込 刀
幅 : 一 巾 口 田
薄 : 十 汁 寸 田 丶 艾
猫 : 田 犯 艾
税 : 禾 口 并 儿
低 : 化 氏 一
縄 : 亀 糸 幺 小 田 乙 勹
布 : ノ 一 巾
李 : 子 木
争 : ヨ 一 亅 勹
精 : 月 青 土 二 米 亠
為 : ノ 杰 ユ 丶 并 勹
誌 : 言 士 心
狙 : 一 犯 目
髪 : 夂 一 長 彡 髟
節 : 艮 竹 卩 乞
勢 : 土 力 丶 儿 九
許 : ノ 干 言 十 乞
昨 : ｜ ノ 日
庫 : 車 广
銀 : 金 艮
涼 : 口 汁 小 亠
傷 : ノ 化 日 勿 一 人 勹 乞
萌 : 月 日 艾
徳 : 十 心 買 彳
鹿 : 鹿 比 广
億 : 音 化 心 日 立
御 : ノ 止 卩 彳 乞
除 : 示 个 阡 一
筋 : 月 竹 力 乞
胸 : 月 凵 勹 ノ 丶
倒 : 化 刈 至 土 厶
裁 : 土 亠 厶 戈 衣
洋 : 王 汁 并 羊
及 : 丶 及 乃 ノ
講 : 言 冂 一 十
源 : 汁 小 白 厂
茄 : 口 力 艾
領 : 貝 目 ハ 頁 个 卩 一
倉 : ノ 口 个 尸 一
鳥 : 鳥 杰
札 : 乙 木
群 : 一 王 口 并 羊 ノ ヨ
採 : 爪 木 扎
妻 : ｜ ヨ 一 女
裏 : 衣 里 亠
刻 : 刈 亠 人 ノ 丶
派 : 斤 汁 厂
険 : 口 人 个 阡
夕 : 夕
怪 : 土 忙 又
梢 : 月 尚 木
閉 : ノ 一 門 亅
訴 : 斤 言 丶
娘 : 艮 女
恵 : 一 心 田
被 : 初 皮 又
適 : 口 込 十 并 立 亠 冂 滴
互 : ヨ 一 彑
岩 : 口 山 石
執 : ノ 九 十 辛 土 立 丶 亠
震 : 衣 雨 辰 厂
積 : 禾 貝 目 ハ 土 亠 二
占 : 口 卜
富 : 口 田 宀 一
繁 : 糸 幺 小 母 攵 毋 乞
亡 : 亡 亠
眼 : 艮 目
皆 : 白 比
雪 : ヨ 雨
壊 : 衣 十 土 買 亠
武 : 止 弋
捕 : 十 用 丶 扎
模 : 大 日 木 艾
帳 : 巾 長
守 : 寸 宀
催 : 化 山 隹
掛 : 土 卜 扎
仲 : ｜ 化 口
枚 : 木 攵 乞
困 : 木 囗
避 : 口 込 十 辛 立 尸
耳 : 耳
労 : 尚 力 冖
透 : ノ 禾 込 乃
隣 : 舛 米 夕 阡
七 : 乙 匕 ノ
測 : 貝 目 ハ 刈 汁
陸 : 土 儿 阡
魅 : ｜ 鬼 田 二 ハ 木 亠 儿 匕 厶
勉 : 力 免 儿 勹
煙 : 火 西 土
砂 : ノ 口 小 石
慣 : 貝 目 ハ 母 忙 毋
奥 : 大 米 冂
肉 : 肉 冂 人
述 : 込 十 丶 木
概 : 牙 艮 木
勤 : 土 力 艾 口 二 一
恐 : 工 心 丶 几
射 : 身 寸
吹 : 欠 口
宿 : 化 白 宀
況 : 口 汁 儿
服 : 月 又 卩
課 : 言 田 木
午 : ノ 干 十 乞
韓 : 十 日 韋 口
短 : 口 豆 并 矢 乞
浩 : ノ 口 汁 土
鳴 : 口 鳥 杰
黙 : 犬 里 杰 黒
殿 : ｜ 一 二 ハ 尸 殳 几 又
壁 : 口 十 辛 土 立 尸
聖 : 王 口 耳
舎 : 口 土 个
昔 : ｜ 一 二 日
借 : 化 日 廾 二
従 : 并 疋 彳
拠 : 几 夂 扎
継 : ｜ 糸 幺 小 米
籍 : ｜ 一 竹 土 日 ハ 木 亠 耒 二 ノ 乞
孝 : 子 老
密 : ノ 山 心 丶 宀
率 : 玄 十 亠 冫 幺
築 : 工 竹 木 丶 几
束 : ｜ 一 口 ハ 木
庭 : 王 广 廴
裕 : 口 初 谷 ハ 个
温 : 皿 汁 日
担 : 一 日 扎
祭 : 示 二 小 个 癶
驚 : 口 馬 勹 夂 艾 攵 杰 乞
則 : 貝 目 ハ 刈
鈴 : 金 个 卩 一
混 : 汁 日 比
珠 : ｜ ノ 王 牛 二 ハ 木
昼 : 一 日 尸 丶
超 : 口 走 土 刀
略 : 口 田 夂
遺 : 一 貝 目 ハ 込 口 ｜
己 : 已
漫 : 汁 日 買 又
矢 : ノ 大 一 矢 乞
腕 : 月 夕 卩 宀
婦 : ヨ 巾 女 冖
牧 : 牛 攵 乞
巻 : 大 二 并 已
届 : ｜ 日 尸 田
飯 : 食 又 厂
劇 : 刈 卜 匕 厂 虍 豕
幕 : 巾 大 日 艾
刑 : 刈 廾 ノ 二 一
底 : 氏 广
華 : ｜ 一 艾
惑 : 口 心 戈
衆 : 血 皿 糸
竹 : 竹 乞
哲 : 斤 口 扎
伸 : ｜ 化 日 田
脱 : 月 口 并 儿
泣 : 汁 立
趣 : 耳 走 土 又
腹 : 月 日 夂 ノ 一 人 乞
誘 : 乃 禾 言 ノ
筆 : 竹 聿 乞
昇 : ノ 日 廾 十
敗 : 貝 目 ハ 攵 乞
候 : ｜ 化 矢 ユ 乞
減 : 口 汁 亅 戈
悟 : 口 忙 五
怖 : ノ 一 巾 忙
聴 : 耳 十 心 買
妙 : ノ 女 小
拍 : 白 扎
致 : 至 土 厶 攵 乞
融 : 口 虫 儿 冂 鬲
揺 : 干 爪 凵 扎
伊 : ｜ ヨ 化
乱 : 乙 口 舌
晴 : 月 青 土 二 日 亠
軍 : 車 冖
額 : 貝 目 ハ 口 頁 夂 宀
就 : 口 小 丶 亠 尤 尢
憶 : 音 心 日 忙 立
脆 : 月 厂 勹 卩
迷 : 込 米
船 : 口 舟 ハ
諸 : 言 日 老
肩 : 月 戸 一 尸
騒 : 虫 馬 又 杰
疲 : 皮 又 疔
踏 : 口 水 足 日 止
悲 : 心 非
級 : ノ 糸 幺 小 及
仙 : 化 山
尚 : 口 尚 冂
港 : 汁 ハ 已 井
賃 : 王 化 貝 目 ハ
亜 : ｜ 一 口
択 : 尸 扎 丶
吸 : ノ 口 及
扱 : 扎 及
床 : 木 广
律 : 彳 聿
永 : 水 丶
也 : ｜ 乙 匕 也
丸 : 九 丶
包 : 勹 已
隠 : ノ ヨ 尚 心 阡
逮 : ヨ 込 水 隶
納 : 糸 幺 小 人 冂
輝 : 車 尚 儿 冖 一
爆 : ｜ 一 火 水 日 ハ 井
党 : 口 尚 儿 冖
退 : 込 艮
否 : ノ 一 口 ｜ 丶
称 : ノ 禾 小 一 乞
熊 : 月 匕 厶 杰
症 : 一 止 疔
析 : 斤 木
滅 : ノ 火 汁 戈
羽 : 羽 冫
丈 : ノ 一 丶
駆 : 馬 匚 丶 ノ 杰 杰
植 : 十 木 目
診 : 言 个 彡
燃 : 火 犬 夕 杰
骨 : 月 冖 冂 骨
奴 : 女 又
河 : 口 汁 亅 一
鶴 : 鳥 杰 隹 宀 冖
刺 : 刈 巾 ハ 木 亅 冂
牛 : 牛
雲 : 一 雨 二 厶
仁 : 化 二
令 : 个 卩 一
描 : 田 扎 艾
魚 : 魚 田 杰
徒 : 走 土 彳
輪 : ｜ 一 車 个 冊 廾
喜 : 口 士 豆 并
功 : 工 力
握 : 至 土 厶 尸 扎
闇 : 音 日 門 立
盛 : ノ 皿 戈
迎 : 込 卩
俊 : 化 儿 厶 夂
魔 : 鬼 田 木 儿 匕 广 麻 厶
匂 : 勹 匕
献 : 干 犬 十 并 冂
豊 : ｜ 一 口 豆 日 并
庁 : 一 亅 广
龍 : 月 立
卒 : 十 人 亠
削 : 刈 月 尚
弾 : 弓 十 尚 田
姉 : 巾 女 亠
闘 : 口 寸 豆 并 門
層 : 田 日 并 尸
固 : 口 十 囗
繰 : 口 糸 幺 小 木 品
礼 : 乙 礼
梨 : 禾 刈 木
官 : 口 宀 ｜
委 : 禾 女
寒 : 一 ハ 宀 丶 井
腰 : 月 女 西
駄 : 大 馬 丶 杰
挫 : ｜ 土 人 扎
酔 : 九 十 酉
監 : 皿 臣 二 乞
怒 : 女 心 又
毛 : 毛
紅 : 工 糸 幺 小
操 : 口 木 扎 品
涙 : 戸 汁 大 一 尸
因 : 大 囗
桜 : 女 尚 木
快 : 人 大 二 忙 ユ
給 : 口 糸 幺 小 个 一
袋 : 衣 化 弋 亠
迫 : 込 白
眺 : 目 儿 冫
坊 : 土 方
弁 : 厶 廾
革 : 革 廾 口 十
虫 : 虫
衣 : 衣 亠
染 : 九 汁 木
荒 : 川 艾 亡
幾 : ノ 幺 戈 丶
童 : 里 立
幼 : 力 幺
敵 : 口 十 并 立 亠 冂 攵 滴 乞
充 : 亠 儿 厶
儀 : 一 王 化 并 羊 亅 戈 手
詰 : 言 口 士
曇 : 雨 二 日 厶
跡 : 口 止 赤 足 亠
皮 : 皮 又
釈 : 釆 米 尸 丶
捨 : 口 土 个 扎
訪 : 言 方
締 : 巾 糸 幺 小 并 立 亠 冖
逆 : 込 并 屮
荷 : 化 口 亅 艾 一
液 : 化 汁 亠 攵 夕 乞
練 : ｜ 糸 幺 小 日 ハ 木 田
織 : 音 糸 幺 小 日 立 戈
勇 : 田 力 マ
臨 : ノ 口 臣 品 一 人 乞
慎 : 一 十 ハ 忙 目
蔵 : ノ 臣 戈 艾 厂
攻 : 工 攵 乞
栃 : 斤 木 厂
承 : ノ 二 亅 手
停 : 化 口 亅 亠 冖 一
農 : ｜ 衣 一 辰 日 厂
礎 : 口 石 疋 木
潟 : 臼 汁 勹 杰
属 : ノ 尸 禹
埼 : 口 大 土 ｜ 一
那 : 刀 邦 二
滋 : 一 汁 并 幺
討 : 言 寸
抗 : 亠 几 扎
毅 : 立 亠 殳 豕 几 又
弟 : ｜ ノ 弓 并
季 : 禾 子
甲 : ｜ 日 田
叫 : ｜ 口 十
麺 : 麦 面 夂 土 亠 二
績 : 貝 目 ハ 糸 幺 小 土 亠 二
棚 : 月 木
才 : ノ 一 亅
沈 : 汁 尢 冖
既 : 牙 艮
券 : 一 人 大 刀 二 并
亀 : 亀 田 勹 乙
免 : ｜ 一 勹 口 儿 免
湯 : ｜ 一 汁 日 勿 勿
鼻 : 自 田 廾 鼻 目
濡 : 雨 而 汁
泉 : 水 白
厚 : 子 日 厂
厳 : 耳 尚 厂 攵 乞
救 : 水 丶 攵 乞
欠 : 欠 勹 人
圧 : 土 厂
覆 : 西 日 夂 彳 乞
絞 : 糸 幺 小 父 亠
霊 : ｜ 一 雨 二
油 : ｜ 汁 日 田
看 : ノ 一 手 二 目
幹 : 干 十 日 个
房 : 戸 方 一 尸
哉 : 口 土 戈
炎 : 火
輸 : 刈 月 車 个 一
岐 : 山 支 又 十
勧 : ノ 力 隹 矢 乞
範 : 乙 車 竹 卩 乞
誕 : ノ 言 止 廴
秘 : ノ 禾 心 丶
危 : 勹 厂 卩
孤 : 瓜 子
悠 : ｜ 化 心 夂 攵 乞
漢 : 汁 艾 口 一 大 二
易 : 日 勿 勹 ノ
麻 : 木 广 麻
吐 : 口 土
灯 : 一 火 亅
幌 : 巾 尚 日 儿
訟 : 言 ハ 厶
翼 : ｜ 一 羽 田 二 ハ 冫 井
埋 : 土 里
鏡 : 音 金 日 立 儿
頬 : 貝 目 ハ 人 頁 二 并 大
瀬 : ｜ 貝 目 ハ 汁 頁 木 口
句 : 口 勹
邪 : 牙 邦
洞 : 口 汁 冂 一
靴 : 化 革 匕
俗 : 化 口 谷 ハ 个
蟻 : 一 王 虫 并 羊 亅 戈 手
善 : 王 口 并 羊
丁 : 一 亅
頑 : 貝 目 ハ 頁 儿 二 元
慢 : 日 買 忙 又
塾 : 丶 九 口 子 土 亠
洗 : ノ 汁 土 儿
寂 : 小 卜 又 宀
督 : 小 卜 又 目
秀 : 乃 禾 ノ
請 : 月 言 青 土 二 亠
契 : 大 土 刀 亠 二
叩 : 口 卩
患 : ｜ 口 心
汗 : 干 汁
泊 : 汁 白
侵 : ヨ 化 又 冖
豪 : 口 亠 冖 豕
枝 : 支 木 十 又
衝 : ｜ 行 日 彳 里 ノ
倍 : 化 口 立
潰 : 貝 目 ハ 汁 十 口 ｜ 一
圭 : 土
唇 : 衣 口 辰 厂
署 : 日 買 老
到 : 刈 至 土 厶
陰 : 二 个 厶 阡 一
貨 : 化 貝 目 ハ 匕
傾 : 化 貝 目 ハ 頁 匕
徴 : 王 山 彳 攵 乞
益 : 一 皿 ハ 并
箱 : 竹 木 目 乞
黄 : 黄 田 ハ
寺 : 寸 土
栄 : 尚 木 冖
頂 : 一 貝 目 ハ 頁 亅
託 : ノ 一 乙 言
巡 : 込 巛
欧 : 欠 匚 ノ 丶
仏 : 化 厶
仮 : 化 又 厂
狭 : 人 大 二 并 犯 丶 亠
均 : 土 冫 勹 二
網 : 亡 糸 幺 小 并 冂
副 : 一 刈 口 田
肌 : 月 几
翻 : 羽 田 釆 米 冫
嘘 : 口 卜 匕 厂 虍
阜 : 阡 十 口 ｜
剣 : 刈 口 人 个
昭 : 口 刀 日
臭 : 自 大 目
挑 : 儿 冫 扎
飾 : ノ 巾 食 一 人 乞
踊 : 口 足 用 マ 止
塚 : 土 冖 豕
棄 : 一 木 亠 凵 厶
茂 : ノ 戈 艾
崩 : 月 山
干 : 干 十 一
悔 : 母 忙 毋 ノ 一 人 乞
喫 : 口 大 土 刀 亠 二
滝 : 汁 田 立 竜
遣 : ｜ 一 口 込
奏 : 一 禾 大 二 人
齢 : 止 歯 米 个 凵 卩 一
盤 : 皿 舟 殳 几 又
尋 : ヨ 口 工 寸
詞 : 言 口 亅 一
懸 : ノ 糸 幺 小 心 目
妊 : ノ 王 士 女
喋 : 口 木 世
媛 : ノ 女 爪 又
宣 : 一 日 宀
閣 : 口 門 夂
損 : 貝 目 ハ 口 扎
騎 : 口 大 馬 亅 一 杰
濃 : ｜ 衣 一 汁 辰 日 厂
僚 : 化 小 日 大
雇 : 戸 隹 一 尸
隊 : 并 豕 阡
暇 : 日 又
辛 : 十 辛 立
覇 : 革 月 西
拡 : 厶 广 扎
浴 : 口 汁 谷 ハ 个
冗 : 冖 几
鑑 : 金 皿 臣 二 乞
郵 : ｜ ノ 一 邦
養 : 王 食 并 羊
柱 : 王 木 丶
距 : 口 足 匚 巨 止
妄 : 亡 女 亠
桐 : 口 木 冂 一
銃 : 金 亠 儿 厶
甘 : 甘
銭 : 金 戈 二
阿 : 一 口 亅 阡
嬉 : 口 士 女 豆 并
橘 : 口 矛 木 儿 冂
伯 : 化 白
柄 : 一 人 木 冂
狂 : 王 犯
尽 : 尸 丶
泰 : ｜ 一 水 二 人 大
併 : ｜ ノ 一 化 二 并 廾
輔 : 車 十 用 丶
矩 : 矢 巨 乞
恥 : 耳 心
乾 : 乙 十 日 ノ 一 人 乞
柳 : 木 卩
緊 : 糸 幺 小 臣 又
随 : ノ 一 月 込 阡
較 : 車 父 亠
暦 : 日 麻 木 厂 广
汚 : 一 汁 勹 二
核 : 人 木 亠 ノ 丶
臓 : ノ 月 臣 戈 艾 厂
歯 : 止 歯 米 凵
脚 : 月 土 卩 厶
郡 : 一 口 邦 ノ ヨ
誠 : ノ 言 戈
菜 : 爪 木 艾
奪 : 寸 大 隹
渋 : 止 汁 冫
敦 : 口 子 亠 攵 乞
冊 : ｜ 一 亅 冂 廾 冊
岸 : 干 山 厂
躍 : ヨ 口 足 隹 止
旧 : ｜ 日
晩 : 免 日 儿 勹
瞳 : 目 里 立
鍵 : 金 廴 聿
航 : 舟 亠 几
雰 : 雨 刀 ハ
扉 : 戸 非 一 尸
郷 : 艮 邦 幺
延 : 一 止 廴
襲 : 衣 月 立 亠
屈 : ｜ 山 尸
祥 : 王 并 羊 礼
勘 : 力 匚 甘 儿
縁 : ヨ 糸 幺 小 豕
控 : 穴 工 儿 宀 扎
漏 : 雨 汁 尸
智 : 口 日 矢 乞
克 : 口 十 儿
凍 : ｜ 一 日 木 冫 田
憲 : 心 土 買 亠 宀 二
圏 : 一 人 大 二 并 囗 已
暴 : ｜ 一 水 二 日 ハ 井
搭 : 口 个 扎 艾 一
彩 : 爪 木 彡
緑 : ヨ 糸 幺 小 水 隶
竜 : 立 竜 田 乙
焦 : 杰 隹
柔 : 矛 木 マ
撮 : 耳 日 又 扎
坦 : 一 土 日
陶 : 缶 勹 阡
祈 : 斤 礼
仰 : 化 卩
机 : 木 几
謎 : 言 込 米
玄 : 玄 亠 幺
麗 : 一 鹿 比 冂 广
藩 : 汁 田 釆 米 艾
暖 : ノ 一 爪 日 又
獣 : 犬 口 尚 田
欣 : 斤 欠
敷 : 十 田 方 丶 攵 乞
又 : 又
隅 : 田 日 冂 厶 禹 阡
露 : 雨 口 足 夂 止
暑 : 日 老
尻 : 九 尸
捜 : ｜ 日 又 扎 田
呆 : 口 木
潜 : 汁 日 二 大
豆 : 口 豆 并
双 : 又 丶
咲 : 口 人 大 二 并 一
覗 : 見 口 亅 一
祖 : 一 目 礼
畿 : 田 幺 戈 丶 ノ
縮 : 化 糸 幺 小 白 宀
葬 : 一 夕 匕 廾 艾
貸 : 化 貝 目 ハ 弋
舗 : 口 十 土 用 个 丶
顧 : 貝 目 ハ 戸 頁 隹 一 尸
祝 : 口 礼 儿
霧 : 雨 矛 力 夂
漁 : 魚 汁 田 杰
拓 : 口 石 扎
摩 : 手 木 广 麻
債 : 化 貝 目 ハ 土 亠 二
努 : 女 又 力
綾 : 糸 幺 小 土 儿 夂
雷 : 雨 田
廊 : 艮 邦 广
審 : 田 釆 米 宀
賢 : 貝 目 ハ 臣 又
贈 : 貝 目 ハ 田 日 并
翔 : 羽 并 羊 冫
噂 : 口 寸 西 并
掴 : 王 囗 扎 丶
舌 : 口 舌
翅 : 羽 支 冫 又 十
塗 : 汁 土 ハ 个 亅 木 一
但 : 一 化 日
却 : 土 卩 厶
慌 : 川 忙 艾 亡
浅 : 汁 戈 二
祉 : 止 礼
卓 : 十 日 卜
摘 : 口 十 并 立 亠 冂 扎 滴
掌 : 口 手 尚 冖
浦 : 十 汁 用 丶
抑 : 卩 扎
缶 : 缶 凵 山
懐 : 衣 十 買 忙 亠
哀 : 衣 口 亠
廃 : 一 儿 广 癶
湾 : 弓 汁 亠
盲 : 亡 目 亠
序 : 子 广 亅 マ 一
湖 : 月 口 十 汁
偶 : 化 田 冂 厶 禹
苛 : 一 口 亅 艾
償 : 化 貝 目 ハ 口 尚 冖
旬 : 日 勹
穴 : 穴 ハ 宀 儿
羅 : 糸 幺 小 買 隹
隙 : 小 日 阡
篇 : ｜ 一 戸 竹 冂 冊 尸 廾 乞
招 : 口 刀 扎
寛 : 見 宀 艾
忙 : 亡 忙 亠
漂 : 示 二 小 汁 西
抵 : 氏 扎
嶋 : 山 鳥 杰
添 : ノ 汁 心 大 一 二
膝 : 月 水 木 个
促 : 化 口 足 止
貯 : 一 貝 目 ハ 亅 宀
批 : 比 扎
挨 : 矢 厶 扎 乞
拶 : 巛 夕 扎
脇 : 月 力
即 : 艮 卩
拐 : 口 刀 扎
皇 : 王 白
閲 : 口 并 門 儿
嵐 : 山 風
傍 : 化 并 方 立 亠 冖
寿 : ノ 一 寸 二
彦 : 并 立 亠 厂 彡
翌 : 羽 立 冫
邦 : ノ 二 邦
徹 : 月 亠 厶 彳 攵 乞
縛 : 糸 幺 小 十 寸 田 丶
羊 : 王 并 羊
毒 : 土 母 亠 毋 二
鎖 : 貝 目 ハ 金 尚
獄 : 言 犯 犬
蹴 : ノ 乙 口 小 足 丶 亠 尤 尢 止
穏 : ヨ 禾 心 爪
拒 : 匚 扎 巨
臣 : 臣 匚
堅 : 臣 土 又
鬼 : 鬼 田 儿 匕 厶
釣 : 金 丶 勹
呪 : 口 儿
挿 : ｜ ノ 十 日 扎 田
脈 : 斤 月 厂
械 : 木 廾 戈
頷 : 貝 目 ハ 口 頁 个 一
塞 : 一 土 ハ 宀
潮 : 月 十 汁 日
欄 : ｜ 一 日 木 門 田
旨 : 日 匕
姓 : 女 生
妹 : ｜ 女 二 ハ 木 亠
酸 : 酉 儿 厶 夂
粧 : 土 米 广
匹 : 儿 匚
粋 : 九 十 米
慮 : 心 田 卜 匕 厂 虍
椅 : 口 大 木 一 亅
還 : 衣 口 込 買 一
墓 : 大 土 日 艾
桁 : 行 木 彳
秒 : ノ 禾 小
殊 : ｜ ノ 牛 二 ハ 木 歹
喉 : 化 口 矢 乞
拭 : 工 弋 扎
粒 : 米 立
凡 : 丶 几
緩 : 糸 幺 小 爪 一 ノ 又
阻 : 一 目 阡
錯 : 金 日 廾 二
忍 : 心 刀 丶
湧 : 汁 田 力 マ
駐 : 王 馬 丶 杰
昧 : ｜ 二 日 ハ 木 亠
砲 : 口 石 勹 已
某 : 甘 木
愚 : 心 田 冂 厶 禹
扇 : 羽 戸 冫 一 尸
敬 : 口 勹 攵 艾 乞
維 : 糸 幺 小 隹
逸 : ノ 込 免 儿 勹
狩 : 寸 犯 宀
灰 : 火 厂
潔 : 糸 幺 小 汁 土 刀 亠 二
滑 : 月 骨 汁 冂 冖
没 : 汁 殳 几 又
紛 : 糸 幺 小 刀 ハ
如 : 口 女
鬱 : 缶 木 冖 凵 匕 彡 鬯
凄 : 女 冫 ヨ 十
溜 : 汁 刀 厶 田
呟 : 玄 口 亠 幺
皿 : 皿
揮 : 車 冖 扎
枠 : 九 十 木
呂 : 口 ノ
膨 : 月 口 十 土 豆 并 彡
括 : ノ 口 十 舌 扎
唯 : 口 隹
忠 : ｜ 口 心
耐 : 而 寸
預 : 貝 目 ハ 欠 マ 一 亅 頁
珍 : 王 个 彡
偽 : 化 丶 杰 ユ ノ 并 勹
猿 : 衣 口 土 犯
曖 : 心 爪 日 冖 夂
沿 : 口 汁 ハ
畳 : 一 田 冖
喧 : 一 口 日 宀
憎 : 田 日 并 忙
奮 : 大 田 隹
岳 : 山 斤 一
譲 : 衣 言 ハ 亠
譜 : ｜ 一 言 二 日 并
唱 : 口 日
輩 : 車 非
跳 : 口 足 儿 冫 止
訂 : 一 言 亅
斉 : ｜ ノ 文 廾 斉
晋 : 一 日
訊 : ノ 言 几
魂 : 鬼 田 二 儿 匕 厶
殴 : ノ 丶 匚 殳 几 又
挟 : 人 大 二 并 丶 亠 扎
晶 : 日
浪 : 艮 汁
畑 : 火 田
縦 : 糸 幺 小 并 疋 彳
胆 : 一 月 日
裸 : 初 田 木
渉 : ノ 止 汁 小
姫 : 女 臣
拉 : 立 扎
拝 : ｜ 一 干 扎
痴 : 口 矢 疔 乞
賛 : 貝 目 ハ 人 大 二 亠
歓 : 欠 隹 矢 乞
淡 : 火 汁
妨 : 女 方
髭 : 止 長 匕 彡 髟
云 : 一 二 厶
呑 : ノ 口 大
浸 : ヨ 汁 又 冖
薗 : 衣 口 土 囗 艾
糖 : 口 米 广
菅 : ｜ 口 宀 艾
伏 : 化 犬
奨 : 寸 大 爪 爿
抽 : ｜ 日 扎 田
癒 : 刈 月 心 个 疔
訓 : 言 川
噛 : 口 止 歯 米
剥 : ヨ 刈 水
遂 : 込 并 豕
鞄 : 革 勹 已
閥 : 化 門 戈
貿 : 貝 目 ハ 刀 厶
獲 : 犯 又 艾 隹
芝 : 亠 艾
湿 : ｜ 汁 日
虹 : 工 虫
杉 : 木 彡
貧 : 貝 目 刀 ハ
憂 : 一 自 心 冖 夂 白
刀 : 刀
該 : 言 人 亠 ノ 丶
斜 : 禾 斗 个 一
欺 : 甘 欠 ハ
諦 : 巾 言 并 立 亠 冖
彫 : 口 土 冂 彡
俳 : 化 非
揚 : 一 日 扎 勿 勿
丘 : 一 斤
佳 : 化 土
硬 : ノ 一 口 石 日 田
凝 : 矢 冫 匕 マ 疋 乞
飼 : 口 艮 亅 个 食
氷 : 水 丶
剤 : ｜ ノ 刈 文 廾 斉
雅 : 牙 隹
烈 : 刈 杰 歹
敏 : 母 攵 毋 乞
窃 : 穴 刀 儿 匕 宀
桂 : 土 木
癖 : 口 十 辛 立 尸 疔
殻 : 士 冖 殳 几 又
糸 : 糸 幺 小
須 : 貝 目 ハ 頁 彡
棒 : ｜ 一 人 木 二 大
鋭 : 金 口 并 个 儿
栗 : 西 木
弓 : 弓
拾 : 口 个 扎 一
飽 : 食 勹 已
威 : ノ 女 戈 厂
軒 : 干 車
辿 : 込 山
貰 : 貝 目 ハ 世
垣 : 一 土 日
頁 : 貝 目 ハ 頁
軟 : 欠 車
粉 : 刀 并 米 ハ
馴 : 川 杰 馬 杰
陣 : 車 阡
貼 : 貝 目 ハ 口 卜
往 : 王 丶 彳
塔 : 口 土 个 艾 一
伴 : ｜ 化 二 并 十
虚 : 一 卜 匕 厂 虍
揃 : 一 刈 月 并 扎
幽 : ｜ 凵 幺
是 : 日 疋
芳 : 方 艾
唐 : ｜ ヨ 一 口 广
封 : 寸 土
掃 : ヨ 巾 冖 扎
昆 : 日 比
戯 : 卜 匕 厂 戈 虍
詐 : ｜ ノ 言
婆 : 汁 女 皮 又
斬 : 斤 車
炭 : 火 山 厂
戒 : 廾 戈
稼 : 禾 宀 豕
冒 : 日 目
泳 : 汁 水 丶
裂 : 衣 刈 歹 亠
溢 : 皿 汁 尚 ハ 并
繋 : 糸 幺 小 車 殳 几 又
尿 : 水 尸
零 : 雨 个 卩 一
遇 : 込 田 冂 厶 禹
魁 : 鬼 田 斗 儿 厶 匕
蘇 : 禾 魚 田 杰 艾
泡 : 汁 勹 已
鍋 : 金 口 冂
磁 : 一 口 石 并 幺
蛇 : 虫 匕 宀
詮 : 王 言 个 ハ
鈍 : 金 屯
煩 : 火 貝 目 ハ 頁
墜 : 土 并 豕 阡
撫 : ｜ ノ 一 扎 杰 無 乞
泥 : 汁 匕 尸
虎 : 卜 儿 匕 厂 虍
孔 : 乙 子
宏 : ノ 一 厶 宀
煮 : 日 老 杰
盟 : 月 皿 日
彰 : 音 十 日 立 彡
誇 : 言 大 二 勹
徐 : 禾 个 彳 一
陥 : ｜ 日 勹 阡
嘩 : 一 口 艾 ｜
駿 : 馬 儿 厶 夂 杰
穂 : 禾 十 心 田
磨 : 口 石 木 广 麻
怠 : 口 心 厶
兼 : ｜ ヨ 一 ハ 并
鉱 : 金 厶 广
冠 : 寸 儿 冖 元
靖 : 月 青 土 二 立 亠
胃 : 月 田
娠 : 衣 女 辰 厂
寧 : 一 心 買 亅 宀 皿
桑 : 又 木
鎌 : 金 王 丶 ノ ヨ 并 ハ
偉 : 化 口 韋
眩 : 玄 目 亠 幺
呉 : 口 ハ
兆 : 儿 冫
拳 : 一 手 并 大 二
沙 : ノ 汁 小
隔 : 一 口 儿 冂 阡 鬲
酷 : ノ 口 土 酉
慰 : 示 二 小 心 寸 尸
掘 : ｜ 山 尸 扎
朗 : 月 艮
琉 : 王 川 亠 厶
叶 : 口 十
朋 : 月
帆 : 巾 丶 几
架 : 口 木 力
爪 : 爪
垂 : ｜ ノ 一
綺 : 口 糸 幺 小 大 亅 一
叔 : 小 卜 又
槽 : ｜ 一 日 木
塀 : ｜ ノ 一 土 二 ハ 尸 廾
絹 : 月 口 糸 幺 小
濁 : 汁 虫 買 勹
軸 : ｜ 車 日 田
弥 : ノ 弓 亅 小 乞
澤 : 十 汁 辛 土 買 立 亠
惜 : ｜ 一 二 日 忙
腐 : 化 寸 肉 广
倫 : ｜ 一 化 个 亅 冊 廾
顎 : 貝 目 ハ 口 頁 二 勹
袖 : ｜ 一 初 田
箇 : 口 十 竹 囗 乞
嫁 : 女 宀 豕
懺 : 人 忙 戈 韭
嬢 : 衣 女 ハ 亠
柴 : 止 木 匕
偏 : ｜ 一 化 戸 冂 冊 尸 廾
憧 : 忙 里 立
澄 : 口 汁 豆 并 癶
胡 : 月 口 十
筒 : 口 竹 冂 乞 一
鉢 : 一 金 木
垢 : ノ 斤 口 土 亅 厂
旗 : 甘 ハ 方 乞
恒 : 一 日 忙
葛 : 日 勹 匕 艾
旦 : 一 日
蓄 : 玄 田 亠 幺 艾
漠 : 汁 大 日 艾
把 : 巴 扎
衡 : 行 大 田 彳 勹
排 : 非 扎
掻 : 虫 又 扎
梗 : ノ 一 日 木 田
囚 : 人 囗
藍 : ノ 皿 臣 二 艾 乞
慶 : 心 冖 夂 广
亮 : 口 亠 儿 冖
貌 : 白 儿 豸
菓 : 田 木 艾
稲 : ｜ 禾 爪 日
征 : 一 止 彳
涯 : 汁 土 厂
乏 : ノ 乙 丶 亠 廴
蒸 : ノ 一 亅 杰 艾
睨 : 臼 目 儿
瞼 : 口 人 目 个 一
膜 : 月 大 日 艾
稚 : 禾 隹
秩 : ノ 禾 人 土 大
滞 : 巾 汁 冖
猛 : 皿 子 犯
慨 : 牙 艮 忙
銘 : 金 口 夕
脂 : 月 日 匕
撲 : 王 人 并 羊 扎 二 大
尊 : 寸 酉 并
溶 : 穴 口 汁 谷 ハ 个 宀
廷 : 王 廴 士
歪 : ｜ ノ 一 止 丶
峰 : ｜ 一 山 夂
睡 : ｜ ノ 一 目
帝 : 巾 并 立 亠 冖
膚 : 月 田 卜 匕 厂 虍
蚊 : 虫 文
媒 : 甘 女 木
枯 : 口 十 木
彙 : ヨ 田 木 冖 彑
壮 : 士 爿
眉 : 目 尸 ｜
矛 : 矛 マ
擦 : ノ 示 二 小 宀 扎 癶
聡 : 耳 心 ハ 厶
椿 : 一 二 日 木 人 大
励 : 斤 力 厂
脅 : 月 力
梶 : 毛 木 尸
唄 : 貝 目 ハ 口
瑞 : 王 山 而
雀 : ノ 小 隹
詫 : ノ 乙 言 宀
壇 : 一 口 土 日 亠 囗
煽 : 羽 火 戸 冫 一 尸
焚 : 火 木
赴 : 走 土 卜
沸 : ｜ ノ 弓 汁
需 : 雨 而
腫 : ｜ 月 日 里 ノ
疾 : 矢 疔 乞
匿 : ノ 口 匚 艾
紺 : 甘 糸 幺 小
帽 : 巾 日 目
鼓 : 口 士 支 豆 并 又 十 鼓
潤 : 王 汁 門
宴 : 女 日 宀
貢 : 貝 目 ハ 工
痩 : 又 疔
恩 : 心 大 囗
謀 : 甘 言 木
旋 : 疋 方 乞
盾 : 斤 十 目 厂
寮 : 小 日 并 大 宀
刃 : 刀 丶
啓 : 戸 口 攵 一 尸 乞
誉 : 一 言 尚 并
肝 : 干 月
吾 : 口 五
菊 : 米 勹 艾
紫 : 止 糸 幺 小 匕
蓋 : 皿 土 厶 艾
恨 : 艮 忙
嘆 : ノ 一 口 艾 二 大
叱 : 口 匕
飴 : 口 食 厶
蘭 : ｜ 一 日 木 門 艾
暫 : 斤 車 日
剖 : 刈 口 立
綱 : 糸 幺 小 并 冂 山 一 岡
頻 : ノ 貝 目 ハ 止 小 頁
殖 : 十 目 歹
擬 : 疋 矢 匕 扎 マ 乞
符 : 化 寸 竹 乞
弧 : 瓜 弓
寸 : 寸
沼 : 口 汁 刀
躊 : 口 工 士 寸 足 止
躇 : 口 足 日 老 艾 止
砕 : ノ 口 十 石 九
俯 : 化 寸 广
蛍 : 尚 虫 冖
苗 : 田 艾
幡 : 巾 田 釆 米
剛 : 刈 并 冂 岡 山
郊 : 父 邦 亠
亭 : 口 亅 亠 冖
堀 : ｜ 山 土 尸
宜 : 一 目 宀
噴 : 貝 目 ハ 口 十 艾
桃 : 木 儿 冫
芦 : 戸 艾 一 尸
践 : 口 足 戈 二 止
肢 : 月 支 十 又
戚 : ノ 小 卜 戈
陀 : 匕 宀 阡
鍛 : 金 殳 几 又
渇 : 汁 日 勹 匕
渦 : ｜ 口 汁 冂
窮 : 弓 穴 身 儿 宀
肥 : 月 巴
撤 : 月 亠 厶 扎 攵 乞
孫 : ノ 子 糸 幺 小
巧 : 工 一 勹
簿 : 十 汁 寸 竹 田 丶 乞
賊 : 貝 目 ハ 十 戈
豚 : 月 豕
諾 : ノ 一 言 口 艾
罰 : 刈 言 買
痺 : 十 田 疔
緯 : 口 糸 幺 小 韋
蝶 : 虫 木 世
塩 : 口 皿 土 ノ 一 人 乞
弊 : ｜ 巾 尚 并 冂 廾 攵 乞
燥 : 火 口 木 品
濯 : ヨ 汁 隹
惚 : 心 忙 勿 勿
稽 : 禾 日 匕 尤
皺 : 皮 又 勹 屮
肺 : 巾 月 亠
剰 : ｜ ノ 一 刈
斐 : 非 文
繊 : 糸 幺 小 土 戈 赤
熟 : 丶 九 口 子 亠 杰
丹 : ノ 一 丶 亅
狼 : 艮 犯
吊 : 巾 口
遭 : ｜ 一 込 日
炊 : 火 欠
晒 : 西 日
殆 : 口 厶 歹
洒 : 汁 西
貫 : 貝 目 ハ 母 毋
捉 : 口 足 扎 止
糞 : ｜ 一 田 二 并 米 井
堤 : 土 日 疋
辱 : 衣 寸 辰 厂
塊 : 鬼 田 土 儿 匕 厶
鳩 : 九 鳥 杰
醒 : 生 酉 日
滴 : 口 十 汁 并 立 亠 冂 滴
曳 : 乙 日
硝 : 月 口 尚 石
枕 : ノ 乙 木 冖 尢
僧 : 化 田 日 并
循 : 斤 十 目 厂 彳
鎮 : 金 十 并 目 一 ハ
盧 : 皿 田 卜 匕 厂 虍
奉 : ｜ 一 人 大 二
諭 : 刈 月 言 个 一
醜 : 鬼 田 酉 儿 匕 厶
伺 : 化 口 亅 一
傘 : 十 人 个
滲 : 汁 大 厶 彡
餌 : 艮 耳 食
咥 : 口 至 土 厶
燵 : 火 込 土 并 立 亠 二
巌 : 山 耳 尚 厂 攵 乞
鷹 : 化 鳥 广 杰 隹
菌 : 禾 囗 艾
粘 : 口 米 卜
披 : 皮 又 扎
塵 : 鹿 土 比 广
槻 : 見 人 大 木 一 二
貞 : 貝 目 ハ 卜
胞 : 月 勹 已
戴 : ｜ 一 田 土 二 ハ 戈
筈 : 口 舌 竹 乞
勿 : ノ 勹 勿
堪 : 土 儿 匚 甘
鯉 : 魚 田 里 杰
頓 : 貝 目 ハ 頁 屯
這 : 言 込
淀 : 汁 疋 宀
笹 : 世 竹 乞
羨 : 王 欠 汁 并 羊
卵 : ノ 卜 丶 卩
梅 : 母 木 毋 乞
舟 : 舟
培 : 口 土 立
箸 : 竹 日 老 乞
璧 : 王 口 十 辛 立 尸
遥 : 干 込 爪 凵
淳 : 口 子 汁 亠
綴 : 糸 幺 小 又
朴 : 卜 木
笠 : 竹 立 乞
麦 : 麦 夂 土 二 亠
裾 : 口 十 初 尸
唾 : ｜ ノ 一 口
厄 : 卩 厂
伎 : 化 支 又 十
舐 : 口 氏 舌
嘲 : 月 口 十 日
套 : 大 長 厶
柵 : ｜ 一 木 亅 冂 冊 廾
抄 : ノ 小 扎
斎 : ｜ ノ 文 廾 斉 示 二 小
魯 : 魚 田 日 杰
棟 : ｜ 一 日 木 田
慈 : 一 心 并 幺
檎 : 木 个 亠 冂 厶 禹
琴 : 王 个 一
芽 : 牙 艾
顕 : 貝 目 ハ 日 頁
汲 : ノ 汁 及
誓 : 斤 言 扎
敢 : 耳 攵 乞
遷 : 込 西 大 已
憩 : 口 自 心 舌 目
廻 : 口 囗 廴
巾 : 巾 冂 ｜
遮 : 一 込 广 杰
巣 : 尚 田 木
郭 : 口 邦 亅 亠 子
措 : ｜ 一 二 日 扎
荘 : 士 爿 艾
國 : 口 囗 戈
悦 : 口 并 忙 儿
穫 : 禾 又 艾 隹
憤 : 貝 目 ハ 十 忙 艾
蒼 : ノ 口 个 艾 一
刈 : 刈
汎 : 汁 丶 几
尼 : 匕 尸
累 : 糸 幺 小 田
妥 : 女 爪
盆 : 皿 刀 ハ
騙 : ｜ 一 戸 馬 冂 冊 尸 杰 廾
軌 : 車 九
賑 : 貝 目 ハ 辰 衣
贅 : 貝 目 ハ 土 方 攵 乞
韻 : 音 貝 目 ハ 口 日 立
悶 : 心 門
堵 : 土 日 老
鹸 : 口 十 人 个 囗 鹵
埃 : 土 矢 厶 乞
撒 : ｜ 月 夂 扎 攵 廾 二 乞
孕 : 乃 子 ノ
岬 : ｜ 山 日 田
菱 : 土 儿 夂 艾
椎 : 木 隹
謡 : 干 言 爪 凵
乃 : ｜ ノ 一 乃
疎 : ｜ 一 口 止 木
臆 : 音 月 心 日 立
拗 : 力 幺 扎
漬 : 貝 目 ハ 汁 土 亠 二
亨 : 口 亠 一 亅
播 : 田 釆 米 扎
妬 : 口 女 石
訝 : 牙 言
艶 : ｜ 口 色 豆 日 并 勹
勾 : 勹 厶
霞 : 雨 又
溝 : 汁 冂 一 十 ｜
捻 : ｜ 一 心 个 扎
陳 : ｜ 一 田 日 木 阡
銅 : 金 口 冂 一
虐 : 卜 匕 匚 厂 虍
攣 : 言 糸 幺 小 手
肪 : 月 方
犠 : 一 王 牛 并 羊 亅 戈 手
牲 : 牛 生
摂 : 耳 冫 扎
蓑 : 衣 一 亠 艾
弦 : 弓 玄 亠 幺
宛 : 夕 卩 宀
貶 : ノ 乙 貝 目 ハ 亠
厭 : 月 犬 日 厂
爺 : 耳 父 邦
賭 : 貝 目 ハ 日 老
遍 : ｜ 一 戸 込 冂 冊 尸 廾
藻 : 口 汁 木 艾 品
樫 : 臣 土 又 木
嗅 : 口 自 大 目 犬
紐 : ｜ 一 糸 幺 小
紳 : ｜ 糸 幺 小 日 田
炬 : 火 匚 巨
卸 : ノ 止 卩 乞
紋 : 糸 幺 小 文
釧 : 金 川
琢 : 王 豕
賠 : 貝 目 ハ 口 立
塁 : 田 土 冫
班 : 王 土 厂 刀
腺 : 月 水 白
瘍 : ノ 一 日 勹 疔 勿
坪 : 干 土 并
愉 : 刈 月 忙 个 一
嘉 : 口 士 力
乙 : 乙
湘 : 汁 木 目
股 : 月 殳 几 又
汁 : 十 汁
痙 : 工 巛 疔
艦 : 皿 舟 臣 二 乞
